Rank,Release Group,Worldwide,Domestic,Foreign,Year,Domestic %,Foreign %
1,Avengers: Endgame,2797501328,858373000,1939128328,2019,0.30683560054417247,0.6931643994558275
2,Avengers: Infinity War,2048359754,678815482,1369544272,2018,0.3313946589091205,0.6686053410908794
3,Spider-Man: No Way Home,1892747988,804747988,1088000000,2021,0.42517439886455716,0.5748256011354429
4,The Lion King,1656943394,543638043,1113305351,2019,0.32809693135479556,0.6719030686452044
5,Frozen II,1450026933,477373578,972653355,2019,0.329217042205105,0.6707829577948949
6,Black Panther,1346913161,700059566,646853595,2018,0.5197510769589992,0.4802489230410007
7,Jurassic World: Fallen Kingdom,1308467944,417719760,890748184,2018,0.3192434036427567,0.6807565963572433
8,Incredibles 2,1242805359,608581744,634223615,2018,0.48968387494698595,0.510316125053014
9,Aquaman,1148461807,335061807,813400000,2018,0.2917483236776023,0.7082516763223977
10,Spider-Man: Far from Home,1131927996,390532085,741395911,2019,0.345014953583673,0.654985046416327
11,Captain Marvel,1128274794,426829839,701444955,2019,0.3783030882811692,0.6216969117188308
12,Joker,1074251311,335451311,738800000,2019,0.3122652097931673,0.6877347902068327
13,Star Wars: Episode IX - The Rise of Skywalker,1074144248,515202542,558941706,2019,0.4796399952420543,0.5203600047579457
14,Toy Story 4,1073394593,434038008,639356585,2019,0.4043601587249657,0.5956398412750342
15,Aladdin,1050693953,355559216,695134737,2019,0.3384041708670612,0.6615958291329388
16,Bohemian Rhapsody,903655259,216428042,687227217,2018,0.23950288546929155,0.7604971145307085
17,The Battle at Lake Changjin,902540935,342411,902198524,2021,0.00037938556216289516,0.9996206144378371
18,Doctor Strange in the Multiverse of Madness,880983652,378050351,502933301,2022,0.4291230037489958,0.5708769962510042
19,Venom,856085151,213515506,642569645,2018,0.24940919224050412,0.7505908077594958
20,"Hi, Mom",822009764,0,822009764,2021,0.0,1.0
21,Jumanji: The Next Level,800059707,320314960,479744747,2019,0.4003638193467978,0.5996361806532021
22,Mission: Impossible - Fallout,791115104,220159104,570956000,2018,0.27828959766643513,0.7217104023335649
23,No Time to Die,774153007,160891007,613262000,2021,0.20782843384344046,0.7921715661565596
24,The Batman,770336695,369336695,401000000,2022,0.4794483988588912,0.5205516011411089
25,Fast & Furious Presents: Hobbs & Shaw,759056935,173956935,585100000,2019,0.22917508157671992,0.77082491842328
26,Deadpool 2,734546611,318491426,416055185,2018,0.43358912998919275,0.5664108700108073
27,F9: The Fast Saga,726229501,173005945,553223556,2021,0.23822489276705933,0.7617751072329407
28,Ne Zha,726063471,3695533,722367938,2019,0.005089820859476899,0.9949101791405232
29,The Wandering Earth,699856699,5971413,693885286,2019,0.008532336703402763,0.9914676632965972
30,Detective Chinatown 3,686257563,0,686257563,2021,0.0,1.0
31,Fantastic Beasts: The Crimes of Grindelwald,654855901,159555901,495300000,2018,0.24365039813545178,0.7563496018645482
32,Water Gate Bridge,626571280,117294,626453986,2022,0.00018719977079064332,0.9998128002292094
33,Ant-Man and the Wasp,622674139,216648740,406025399,2018,0.3479327732285988,0.6520672267714012
34,Ready Player One,582890172,137690172,445200000,2018,0.23621975221774713,0.7637802477822528
35,Operation Red Sea,579330426,1543547,577786879,2018,0.0026643637736368433,0.9973356362263631
36,Detective Chinatown 2,544185156,1983984,542201172,2018,0.0036457885301083076,0.9963542114698917
37,The Meg,530243742,145443742,384800000,2018,0.2742960085703378,0.7257039914296621
38,Ralph Breaks the Internet,529323962,201091711,328232251,2018,0.3799029052835511,0.6200970947164489
39,Hotel Transylvania 3: Summer Vacation,528583774,167510016,361073758,2018,0.31690343941583043,0.6830965605841696
40,How to Train Your Dragon: The Hidden World,521799505,160799505,361000000,2019,0.3081633912243746,0.6918366087756255
41,The Grinch,511595957,270620950,240975007,2018,0.5289739809261237,0.4710260190738763
42,Venom: Let There Be Carnage,506863592,213550366,293313226,2021,0.42131723282267236,0.5786827671773277
43,Maleficent: Mistress of Evil,491730089,113929605,377800484,2019,0.23169134358178353,0.7683086564182164
44,It Chapter Two,473093228,211593228,261500000,2019,0.44725482310222375,0.5527451768977762
45,Godzilla vs. Kong,468216094,100916094,367300000,2021,0.2155331593535527,0.7844668406464473
46,Bumblebee,467989645,127195589,340794056,2018,0.2717914602576303,0.7282085397423698
47,The Eight Hundred,461421559,372755,461048804,2020,0.0008078404502985089,0.9991921595497015
48,Demon Slayer the Movie: Mugen Train,453210959,49505008,403705951,2020,0.10923170990664416,0.8907682900933558
49,Dying to Survive,451176639,0,451176639,2018,0.0,1.0
50,"My People, My Country",450064993,2356683,447708310,2019,0.005236317057878794,0.9947636829421213
51,A Star Is Born,436188866,215288866,220900000,2018,0.4935679995096436,0.5064320004903564
52,Pok√©mon Detective Pikachu,433005346,144105346,288900000,2019,0.3328026947731957,0.6671973052268043
53,Shang-Chi and the Legend of the Ten Rings,432243292,224543292,207700000,2021,0.5194835782437082,0.48051642175629183
54,The Secret Life of Pets 2,430051293,158874395,271176898,2019,0.36943126921374003,0.63056873078626
55,Rampage,428028233,101028233,327000000,2018,0.2360317035441912,0.7639682964558088
56,Bad Boys for Life,426505244,206305244,220200000,2020,0.4837109200936343,0.5162890799063657
57,"My People, My Homeland",422390820,0,422390820,2020,0.0,1.0
58,The Captain,417282021,706572,416575449,2019,0.0016932720904359309,0.9983067279095641
59,Sing 2,409753307,162790990,246962317,2021,0.3972902407838285,0.6027097592161715
60,Alita: Battle Angel,404980543,85838210,319142333,2019,0.21195638033405473,0.7880436196659453
61,Eternals,402064899,164870234,237194665,2021,0.41005876019035425,0.5899412398096457
62,Uncharted,400977533,147877533,253100000,2022,0.36879256524330006,0.6312074347566999
63,Dune,400671789,108327830,292343959,2021,0.2703655035718025,0.7296344964281974
64,Fantastic Beasts: The Secrets of Dumbledore,396165662,95065662,301100000,2022,0.23996441670404034,0.7600355832959597
65,Mamma Mia! Here We Go Again,395044706,120634935,274409771,2018,0.3053703369967449,0.6946296630032551
66,Solo: A Star Wars Story,392924807,213767512,179157295,2018,0.5440417815106289,0.4559582184893712
67,Godzilla: King of the Monsters,386600138,110500138,276100000,2019,0.2858253971963145,0.7141746028036855
68,Sonic the Hedgehog 2,386078852,186278852,199800000,2022,0.48248913670101773,0.5175108632989822
69,1917,384919389,159227644,225691745,2019,0.4136649089401937,0.5863350910598063
70,Black Widow,379751655,183651655,196100000,2021,0.4836098870984512,0.5163901129015488
71,Spider-Man: Into the Spider-Verse,375540831,190241310,185299521,2018,0.5065795628491859,0.49342043715081413
72,Once Upon a Time... In Hollywood,374375059,142502728,231872331,2019,0.3806416174748436,0.6193583825251564
73,Fifty Shades Freed,371985018,100407760,271577258,2018,0.26992420431298125,0.7300757956870187
74,Hello Mr. Billionaire,366961907,0,366961907,2018,0.0,1.0
75,Shazam!,365971656,140371656,225600000,2019,0.3835588185550632,0.6164411814449369
76,The Nun,365550119,117450119,248100000,2018,0.32129689718415877,0.6787031028158412
77,Tenet,363704105,58504105,305200000,2020,0.16085632302665376,0.8391436769733462
78,Monster Hunt 2,361682618,706153,360976465,2018,0.0019524106629862981,0.9980475893370137
79,Dumbo,353284621,114766307,238518314,2019,0.32485508900768145,0.6751449109923185
80,Peter Rabbit,351266433,115253424,236013009,2018,0.3281082767165515,0.6718917232834485
81,Mary Poppins Returns,349537494,171958438,177579056,2018,0.4919599211865952,0.5080400788134047
82,A Quiet Place,340939361,188024361,152915000,2018,0.5514891576276522,0.44851084237234784
83,Free Guy,331526598,121626598,209900000,2021,0.36686829573776764,0.6331317042622324
84,Top Gun: Maverick,330637143,191137143,139500000,2022,0.5780873294081179,0.42191267059188203
85,Crazy Alien,327598891,0,327598891,2019,0.0,1.0
86,John Wick: Chapter 3 - Parabellum,326709727,171015687,155694040,2019,0.5234484096030603,0.47655159039693973
87,Green Book,321752656,85080171,236672485,2018,0.26442725308847176,0.7355727469115282
88,Sonic the Hedgehog,319715683,148974665,170741018,2020,0.46595982906475064,0.5340401709352494
89,Knives Out,311605581,165363234,146242347,2019,0.5306812332093628,0.46931876679063717
90,Skyscraper,304868961,68420120,236448841,2018,0.22442468323300382,0.7755753167669962
91,Ocean's Eight,297718711,140218711,157500000,2018,0.47097715333048046,0.5290228466695195
92,A Quiet Place Part II,297372261,160072261,137300000,2021,0.5382891479578857,0.4617108520421143
93,Pacific Rim: Uprising,290930148,59874525,231055623,2018,0.20580378283793402,0.794196217162066
94,Maze Runner: The Death Cure,288175335,58032443,230142892,2018,0.2013789382772818,0.7986210617227182
95,Tomb Raider,274650803,58250803,216400000,2018,0.21209041577060309,0.7879095842293969
96,Terminator: Dark Fate,261119292,62253077,198866215,2019,0.23840856998034446,0.7615914300196556
97,Parasite,258632621,53369749,205262872,2019,0.2063535094438068,0.7936464905561932
98,Pegasus,255863112,0,255863112,2019,0.0,1.0
99,Encanto,255731274,96093622,159637652,2021,0.3757601504773327,0.6242398495226673
100,Halloween,255485178,159342015,96143163,2018,0.6236839892136522,0.37631601078634785
101,Us,255184580,175084580,80100000,2019,0.6861095603817441,0.3138904396182559
102,Men in Black: International,253890701,80001807,173888894,2019,0.31510333653377876,0.6848966634662212
103,X-Men: Dark Phoenix,252442974,65845974,186597000,2019,0.26083504308580996,0.73916495691419
104,Glass,246999039,111048468,135950571,2019,0.44959068848846817,0.5504093115115318
105,Dolittle,245439115,77047065,168392050,2020,0.31391518421992354,0.6860848157800764
106,The Bravest,245179562,290217,244889345,2019,0.0011836916488169597,0.9988163083511831
107,Legend of Deification,240663149,214670,240448479,2020,0.0008919936471038197,0.9991080063528962
108,Crazy Rich Asians,238532921,174532921,64000000,2018,0.7316932198218459,0.2683067801781541
109,Cruella,233503234,86103234,147400000,2021,0.3687453596467105,0.6312546403532895
110,Annabelle Comes Home,231252591,74152591,157100000,2019,0.32065626023623667,0.6793437397637634
111,Better Days,225918798,1921657,223997141,2019,0.008505963279779843,0.9914940367202202
112,Ford v Ferrari,225508210,117624357,107883853,2019,0.521596783549477,0.47840321645052303
113,"My Country, My Parents",221715716,166807,221548909,2021,0.0007523463063845235,0.9992476536936155
114,Jungle Cruise,220889446,116987516,103901930,2021,0.5296202155353317,0.4703797844646684
115,Too Cool to Kill,217254604,185882,217068722,2022,0.000855595216753151,0.9991444047832468
116,Little Women,216601214,108101214,108500000,2019,0.4990794465260938,0.5009205534739062
117,A Little Red Flower,216000000,0,216000000,2020,0.0,1.0
118,The Croods: A New Age,215905815,58568815,157337000,2020,0.271270206409216,0.728729793590784
119,Creed II,214215889,115715889,98500000,2018,0.5401835015142131,0.45981649848578693
120,Smallfoot,214040103,83240103,130800000,2018,0.3888995652370808,0.6111004347629192
121,Nice View,211019042,0,211019042,2022,0.0,1.0
122,Us and Them,209221380,0,209221380,2018,0.0,1.0
123,Raging Fire,205846481,385305,205461176,2021,0.0018718075632296089,0.9981281924367704
124,The Addams Family,203044905,100044905,103000000,2019,0.49272305059809307,0.5072769494019069
125,The Conjuring: The Devil Made Me Do It,202031050,65631050,136400000,2021,0.324856253531326,0.675143746468674
126,Birds of Prey,201858461,84158461,117700000,2020,0.41691817416561006,0.5830818258343899
127,The Bad Guys,201846995,83432995,118414000,2022,0.41334771914736707,0.586652280852633
128,Shock Wave 2,198921659,0,198921659,2020,0.0,1.0
129,The Island,198326350,670883,197655467,2018,0.0033827224672868736,0.9966172775327131
130,Christopher Robin,197744377,99215042,98529335,2018,0.5017338217409844,0.4982661782590157
131,Ghostbusters: Afterlife,197360575,129360575,68000000,2021,0.655452969773725,0.3445470302262749
132,Chinese Doctors,197143218,0,197143218,2021,0.0,1.0
133,Rocketman,195320400,96368160,98952240,2019,0.4933850227625993,0.5066149772374007
134,Weathering with You,193932489,8056636,185875853,2019,0.04154350847319863,0.9584564915268013
135,The Lego Movie 2: The Second Part,192306508,105806508,86500000,2019,0.5501972299346208,0.44980277006537916
136,Downton Abbey,192199131,96853865,95345266,2019,0.5039245728951813,0.4960754271048187
137,Sheep Without a Shepherd,191602146,0,191602146,2019,0.0,1.0
138,The Equalizer 2,190400157,102084362,88315795,2018,0.5361569213411941,0.4638430786588059
139,The White Storm 2: Drug Lords,189396380,609461,188786919,2019,0.003217912612690908,0.9967820873873091
140,Project Gutenberg,188116796,0,188116796,2018,0.0,1.0
141,The Lost City,181634517,102434517,79200000,2022,0.5639595308858613,0.4360404691141387
142,Cliff Walkers,181325565,152972,181172593,2021,0.0008436317294806168,0.9991563682705193
143,Abominable,179053956,60716390,118337566,2019,0.33909549588505045,0.6609045041149496
144,Ip Man 4: The Finale,176345966,3956031,172389935,2019,0.02243335126815433,0.9775666487318456
145,The Mule,174804407,103804407,71000000,2018,0.5938317504775494,0.40616824952245056
146,The Nutcracker and the Four Realms,173961069,54858851,119102218,2018,0.3153513100106323,0.6846486899893677
147,Gemini Man,173469516,48546770,124922746,2019,0.27985764369112553,0.7201423563088745
148,Spies in Disguise,171616764,66757013,104859751,2019,0.3889888810629246,0.6110111189370754
149,Insidious: The Last Key,167885588,67745330,100140258,2018,0.40352081919026905,0.596479180809731
150,The Suicide Squad,167417425,55817425,111600000,2021,0.33340272077413685,0.6665972792258631
151,Wonder Woman 1984,166801036,46801036,120000000,2020,0.28058000790834414,0.7194199920916559
152,Morbius,163309407,73309407,90000000,2022,0.44889886226823417,0.5511011377317658
153,Space Jam: A New Legacy,162892228,70592228,92300000,2021,0.43336768651724744,0.5666323134827526
154,The Sacrifice,161047608,0,161047608,2020,0.0,1.0
155,The Predator,160542134,51024708,109517426,2018,0.3178275181018835,0.6821724818981165
156,Johnny English Strikes Again,158970776,4412170,154558606,2018,0.02775459811556811,0.9722454018844319
157,Hustlers,157563598,104963598,52600000,2019,0.6661665469203109,0.33383345307968915
158,Jujutsu Kaisen 0: The Movie,157040831,29693448,127347383,2021,0.1890810677128931,0.8109189322871069
159,The Climbers,156892866,487157,156405709,2019,0.0031050296448788183,0.9968949703551212
160,The Matrix Resurrections,156575035,37686805,118888230,2021,0.24069485279054864,0.7593051472094514
161,Escape Room,155712077,57005601,98706476,2019,0.36609620845273294,0.6339037915472671
162,Yesterday,154608507,73286650,81321857,2019,0.47401434385496005,0.5259856561450399
163,House of Gucci,153949410,53809574,100139836,2021,0.3495276402813106,0.6504723597186894
164,Peter Rabbit 2: The Runaway,153901717,40501717,113400000,2021,0.2631661152942173,0.7368338847057827
165,Red Sparrow,151572634,46874505,104698129,2018,0.30925440670246584,0.6907455932975342
166,A Writer's Odyssey,150123320,160013,149963307,2021,0.001065877040289277,0.9989341229597107
167,The Angry Birds Movie 2,147792047,41667116,106124931,2019,0.2819307049722371,0.7180692950277628
168,The Boss Baby 2: Family Business,146745280,57300280,89445000,2021,0.3904744329766518,0.6095255670233483
169,Angel Has Fallen,146661977,69030436,77631541,2019,0.470677113537069,0.529322886462931
170,PAW Patrol: The Movie,144327371,40127371,104200000,2021,0.27803022200134164,0.7219697779986584
171,The Invisible Man,143151000,70410000,72741000,2020,0.49185824758471824,0.5081417524152818
172,More Than Blue,142958164,722669,142235495,2018,0.005055108290282743,0.9949448917097172
173,Onward,141940042,61555145,80384897,2020,0.43367004921697855,0.5663299507830215
174,Scream,140041405,81641405,58400000,2022,0.582980476381253,0.4170195236187469
175,Death on the Nile,137295068,45630104,91664964,2022,0.3323506420492832,0.6676493579507168
176,The First Purge,137056262,69488745,67567517,2018,0.5070089026650968,0.49299109733490326
177,How Long Will I Love U,136796719,746933,136049786,2018,0.005460167505918033,0.994539832494082
178,Tom & Jerry,133336687,46536687,86800000,2021,0.34901637386565637,0.6509836261343437
179,A Wrinkle in Time,132675864,100478608,32197256,2018,0.7573239394921144,0.2426760605078856
180,Be Somebody,132326332,0,132326332,2021,0.0,1.0
181,Halloween Kills,131647155,92002155,39645000,2021,0.6988541074055113,0.30114589259448865
182,The House with a Clock in Its Walls,131457147,68549695,62907452,2018,0.521460388912898,0.478539611087102
183,Raya and the Last Dragon,130423032,54723032,75700000,2021,0.4195810445504748,0.5804189554495252
184,Warm Hug,129240236,0,129240236,2020,0.0,1.0
185,Sister,128317206,0,128317206,2021,0.0,1.0
186,Ad Astra,127461872,50188370,77273502,2019,0.393752023350167,0.606247976649833
187,Midway,127420861,56846802,70574059,2019,0.4461341852022174,0.5538658147977826
188,The King's Man,125897478,37176373,88721105,2021,0.29529084768481223,0.7047091523151877
189,The Upside,125852517,108252517,17600000,2019,0.860153770305603,0.13984622969439697
190,The Curse of La Llorona,123133739,54733739,68400000,2019,0.4445064321485438,0.5554935678514562
191,Looking Up,122994583,84267,122910316,2019,0.0006851277344466463,0.9993148722655534
192,Zombieland: Double Tap,122810399,73123082,49687317,2019,0.5954144160056023,0.40458558399439776
193,Last Christmas,121550750,35150750,86400000,2019,0.2891857927655732,0.7108142072344268
194,Soul,120957731,0,120957731,2020,0.0,1.0
195,Instant Family,120556201,67363237,53192964,2018,0.5587704028596588,0.4412295971403412
196,Extreme Job,119932733,1565885,118366848,2019,0.013056360518358236,0.9869436394816418
197,The Addams Family 2,119815153,56489153,63326000,2021,0.4714691888763018,0.5285308111236982
198,Dora and the Lost City of Gold,119682635,60477943,59204692,2019,0.505319280445321,0.4946807195546789
199,Wonder Park,119559110,45216793,74342317,2019,0.37819613244026323,0.6218038675597368
200,A Cool Fish,118153135,551876,117601259,2018,0.004670853634141828,0.9953291463658581
201,P Storm,117991727,326711,117665016,2019,0.0027689314183866466,0.9972310685816134
202,Game Night,117679066,69179066,48500000,2018,0.5878621266419637,0.41213787335803637
203,Dragon Ball Super: Broly,115757940,30712119,85045821,2018,0.26531328218176653,0.7346867178182335
204,Detective Conan: The Fist of Blue Sapphire,115570314,0,115570314,2019,0.0,1.0
205,The Gentlemen,115171795,36471795,78700000,2019,0.31667297535824634,0.6833270246417537
206,The Monkey King 3,115084576,187074,114897502,2018,0.0016255349457081026,0.998374465054292
207,My Love,114016434,86252,113930182,2021,0.0007564874375916721,0.9992435125624083
208,Pet Sematary,113118226,54724696,58393530,2019,0.4837831880425706,0.5162168119574294
209,Boonie Bears: Blast Into the Past,112367881,0,112367881,2019,0.0,1.0
210,The Call of the Wild,111105497,62342368,48763129,2020,0.5611096631879519,0.4388903368120481
211,Good Boys,111037232,83140306,27896926,2019,0.748760613917321,0.251239386082679
212,Clifford the Big Red Dog,107347356,48947356,58400000,2021,0.4559716962195138,0.5440283037804862
213,First Man,105697415,44936545,60760870,2018,0.4251432733714443,0.5748567266285557
214,Scary Stories to Tell in the Dark,104545505,68947075,35598430,2019,0.6594934425922951,0.3405065574077049
215,Book Club,104438188,68566296,35871892,2018,0.6565251400187065,0.34347485998129346
216,Wrath of Man,103966489,27466489,76500000,2021,0.26418598208120697,0.7358140179187931
217,Night School,103105878,77339130,25766748,2018,0.75009428657404,0.24990571342596005
218,Detective Conan: Zero the Enforcer,101860359,0,101860359,2018,0.0,1.0
219,RRR,99746831,11113000,88633831,2022,0.11141206080020728,0.8885879391997927
220,Line Walker 2: Invisible Spy,99482027,296751,99185276,2019,0.002982960932229497,0.9970170390677705
221,Alpha,98203196,35857181,62346015,2018,0.36513252582940375,0.6348674741705962
222,Along With the Gods: The Last 49 Days,97962238,1200246,96761992,2018,0.012252129233715547,0.9877478707662845
223,A Simple Favor,97644617,53548586,44096031,2018,0.5484028474401206,0.4515971525598795
224,Boonie Bears: The Big Shrink,96845907,0,96845907,2018,0.0,1.0
225,The Favourite,95918706,34366783,61551923,2018,0.35829072798375744,0.6417092720162426
226,The New King of Comedy,95618308,0,95618308,2019,0.0,1.0
227,Detective Conan: The Scarlet Bullet,95580715,0,95580715,2021,0.0,1.0
228,Truth or Dare,95330493,41411015,53919478,2018,0.43439421843753606,0.565605781562464
229,The Hustle,95017038,35417038,59600000,2019,0.3727440756467277,0.6272559243532723
230,Adoring,94975692,0,94975692,2019,0.0,1.0
231,Kill Mobile,94870905,0,94870905,2018,0.0,1.0
232,I Feel Pretty,94539426,48795601,45743825,2018,0.5161402291568811,0.48385977084311893
233,Blockers,94017294,60311495,33705799,2018,0.6414936277574634,0.35850637224253656
234,BlacKkKlansman,93400823,49275340,44125483,2018,0.5275685847008008,0.47243141529919924
235,Goosebumps 2: Slappy's Revenge,93320380,46700633,46619747,2018,0.5004333780038187,0.49956662199618135
236,Evangelion: 3.0+1.01 Thrice Upon a Time,92246218,0,92246218,2021,0.0,1.0
237,End Game,91824961,23149,91801812,2021,0.00025209920862367697,0.9997479007913763
238,Shadow,91708374,521396,91186978,2018,0.005685369582498541,0.9943146304175015
239,Crawl,91542097,39014193,52527904,2019,0.4261885436161682,0.5738114563838318
240,Five Feet Apart,91522094,45729221,45792873,2019,0.49965225883052894,0.500347741169471
241,Rambo: Last Blood,91490353,44819352,46671001,2019,0.4898806325514997,0.5101193674485003
242,Overboard,91244913,50316123,40928790,2018,0.551440308787406,0.448559691212594
243,Sherlock Gnomes,90497778,43242871,47254907,2018,0.4778335110062039,0.522166488993796
244,K.G.F: Chapter 2,90367198,2874000,87493198,2022,0.03180357545223434,0.9681964245477657
245,Jojo Rabbit,90335025,33370906,56964119,2019,0.369412705647671,0.630587294352329
246,Old,90146510,48276510,41870000,2021,0.5355338770186444,0.4644661229813556
247,Detective Dee: The Four Heavenly Kings,90040771,262963,89777808,2018,0.0029204880975530517,0.9970795119024469
248,Serial (Bad) Weddings 2,87761988,0,87761988,2019,0.0,1.0
249,"Hello, Mrs. Money",86874070,0,86874070,2018,0.0,1.0
250,Robin Hood,86489031,30824628,55664403,2018,0.35639927564918605,0.643600724350814
251,I Can Only Imagine,86086881,83482352,2604529,2018,0.9697453436604353,0.030254656339564676
252,Hidden Man,85170581,0,85170581,2018,0.0,1.0
253,Mortal Kombat,83726031,42326031,41400000,2021,0.5055301259891324,0.49446987401086767
254,Mortal Engines,83672673,15951040,67721633,2018,0.19063619492591088,0.8093638050740891
255,One Piece: Stampede,81562741,1298528,80264213,2019,0.01592060276640286,0.9840793972335972
256,Dog,81200919,61778069,19422850,2022,0.7608050470463271,0.23919495295367285
257,iPartment the Movie,81096321,0,81096321,2018,0.0,1.0
258,Doraemon the Movie: Nobita's Treasure Island,80920916,0,80920916,2018,0.0,1.0
259,A Dog's Way Home,80708134,42004346,38703788,2019,0.5204474929379485,0.4795525070620515
260,Caught in Time,80543319,0,80543319,2020,0.0,1.0
261,Den of Thieves,80509622,44947622,35562000,2018,0.5582888216764947,0.44171117832350526
262,Jackass Forever,80340218,57743451,22596767,2022,0.718736548611307,0.281263451388693
263,Hereditary,80200936,44069456,36131480,2018,0.5494880508626483,0.4505119491373517
264,Code Blue: The Movie,78778562,0,78778562,2018,0.0,1.0
265,Tag,78130625,54730625,23400000,2018,0.7005015638874001,0.2994984361125999
266,Boonie Bears: The Wild Life,77961427,0,77961427,2021,0.0,1.0
267,Everything Everywhere All at Once,77500174,57889793,19610381,2022,0.7469633939144447,0.2530366060855554
268,Candyman,77411570,61186570,16225000,2021,0.7904060077841077,0.20959399221589228
269,The Forever Purge,76994245,44539245,32455000,2021,0.5784749886176558,0.4215250113823442
270,Sanju,76693052,7909317,68783735,2018,0.10312951165380665,0.8968704883461933
271,Cold Pursuit,76419755,32138862,44280893,2019,0.42055698817668286,0.5794430118233171
272,Vice,76073488,47836282,28237206,2018,0.6288167304751426,0.3711832695248573
273,West Side Story,76016171,38530322,37485849,2021,0.5068700711063177,0.49312992889368235
274,Widows,75984700,42402632,33582068,2018,0.5580417110286676,0.4419582889713324
275,Sicario: Day of the Soldado,75837743,50072235,25765508,2018,0.6602548153364743,0.33974518466352566
276,A Dog's Journey,75741734,22782371,52959363,2019,0.30079019579879174,0.6992098042012083
277,Searching,75462037,26020957,49441080,2018,0.3448218208050758,0.6551781791949242
278,The Spy Who Dumped Me,75320680,33562069,41758611,2018,0.4455890334500432,0.5544109665499568
279,1921,75159828,0,75159828,2021,0.0,1.0
280,Animal World,74922830,0,74922830,2018,0.0,1.0
281,A Madea Family Funeral,74747725,73257045,1490680,2019,0.9800571856869222,0.019942814313077754
282,Cats,73833348,27166770,46666578,2019,0.3679471503852162,0.6320528496147838
283,Charlie's Angels,73279888,17803077,55476811,2019,0.24294629107511737,0.7570537089248827
284,Downton Abbey: A New Era,72855664,31873990,40981674,2022,0.4374950175459248,0.5625049824540752
285,Amazing China,72506343,0,72506343,2018,0.0,1.0
286,Doctor Sleep,72381712,31581712,40800000,2019,0.4363217051290525,0.5636782948709476
287,Second Act,72282227,39282227,33000000,2018,0.5434562357908536,0.45654376420914644
288,What Men Want,72216294,54611903,17604391,2019,0.7562268841987377,0.24377311580126224
289,Spirited Away 2018 Re-release,70186029,1175067,69010962,2018,0.016742178133485795,0.9832578218665142
290,After,69518232,12138565,57379667,2019,0.1746098059570905,0.8253901940429095
291,Exit,69501772,470699,69031073,2019,0.006772474808268198,0.9932275251917319
292,Playing with Fire,69412425,44451847,24960578,2019,0.6404018732957392,0.3595981267042608
293,The Yin-Yang Master: Dream of Eternity,68000000,0,68000000,2020,0.0,1.0
294,Shoplifters,67999335,3313513,64685822,2018,0.04872860889007223,0.9512713911099278
295,A Beautiful Day in the Neighborhood,67925733,61704055,6221678,2019,0.9084046984078921,0.09159530159210796
296,12 Strong,67450815,45819713,21631102,2018,0.6793055502739292,0.32069444972607075
297,War,67179155,4654000,62525155,2019,0.06927744178979328,0.9307225582102068
298,The Northman,67134730,33924730,33210000,2022,0.5053231017686375,0.4946768982313625
299,Mulan,66800000,0,66800000,2020,0.0,1.0
300,"Love, Simon",66316289,40826341,25489948,2018,0.615630663531248,0.38436933646875204
301,Mile 22,66308758,36108758,30200000,2018,0.5445548836851989,0.4554451163148011
302,Hitman's Wife's Bodyguard,65927857,38014727,27913130,2021,0.5766109916177011,0.42338900838229887
303,Life of the Party,65859911,53059911,12800000,2018,0.8056480823364611,0.1943519176635389
304,Escape Room: Tournament of Champions,65774490,25314753,40459737,2021,0.3848719009451841,0.6151280990548159
305,Eiga Doraemon: Nobita no getsumen tansaki,65406606,0,65406606,2019,0.0,1.0
306,Stand by Me Doraemon 2,65201374,0,65201374,2020,0.0,1.0
307,Happy Death Day 2U,64600152,28148130,36452022,2019,0.43572854131984085,0.5642714586801592
308,L Storm,64517456,0,64517456,2018,0.0,1.0
309,Capernaum,64417003,1661096,62755907,2018,0.025786607923997954,0.974213392076002
310,Isle of Dogs,64241499,32015231,32226268,2018,0.49835747139088393,0.5016425286091161
311,The Rescue,64203587,18797,64184790,2020,0.0002927718041672656,0.9997072281958327
312,Belle,64039994,4018313,60021681,2021,0.06274692967647685,0.9372530703235231
313,Detective Conan: The Bride of Halloween,62658785,0,62658785,2022,0.0,1.0
314,Andhadhun,62475342,1193046,61282296,2018,0.019096270013215774,0.9809037299867842
315,White Snake,62098770,34730,62064040,2019,0.0005592703365944285,0.9994407296634056
316,Bombshell,61404394,31762808,29641586,2019,0.5172725587032094,0.48272744129679057
317,Ashfall,61354854,372562,60982292,2019,0.006072249801132279,0.9939277501988677
318,Ma,61105672,45896028,15209644,2019,0.7510927627144007,0.24890723728559927
319,Ron's Gone Wrong,60692022,23009270,37682752,2021,0.37911523198222,0.62088476801778
320,Love You Forever,60670799,0,60670799,2020,0.0,1.0
321,My Best Summer,60011073,0,60011073,2019,0.0,1.0
322,Adrift,59945012,31445012,28500000,2018,0.5245642790095696,0.47543572099043035
323,Cloudy Mountain,58338683,0,58338683,2021,0.0,1.0
324,Avatar 2021 Re-release,57700000,0,57700000,2021,0.0,1.0
325,Ready or Not,57615777,28714231,28901546,2019,0.4983744469852416,0.5016255530147584
326,Jade Dynasty,57149764,0,57149764,2019,0.0,1.0
327,The 15:17 to Paris,57076286,36276286,20800000,2018,0.6355754472181319,0.36442455278186814
328,Das perfekte Geheimnis,56573047,0,56573047,2019,0.0,1.0
329,A or B,56239049,0,56239049,2018,0.0,1.0
330,Nezha Reborn,56088478,0,56088478,2021,0.0,1.0
331,The Big Shot,56040681,0,56040681,2019,0.0,1.0
332,Nobody,55705035,27568035,28137000,2021,0.4948930558970118,0.5051069441029882
333,Hellboy,55064690,21903748,33160942,2019,0.39778209956325916,0.6022179004367408
334,Go Brother!,54663060,0,54663060,2018,0.0,1.0
335,Early Man,54622814,8267544,46355270,2018,0.15135697695838227,0.8486430230416178
336,Upcoming,54300000,0,54300000,2021,0.0,1.0
337,Peppermint,53918723,35418723,18500000,2018,0.6568909838610235,0.34310901613897643
338,Long Shot,53873809,30316271,23557538,2019,0.5627274470234692,0.4372725529765308
339,Man in Love,52946097,0,52946097,2021,0.0,1.0
340,Break Through the Darkness,52700000,0,52700000,2021,0.0,1.0
341,Greenland,52300000,0,52300000,2020,0.0,1.0
342,Tolo Tolo,52186426,0,52186426,2020,0.0,1.0
343,Teen Titans GO! To the Movies,52090236,29790236,22300000,2018,0.5718967370391641,0.4281032629608359
344,Slender Man,51738549,30569484,21169065,2018,0.5908454061979975,0.4091545938020025
345,Schemes in Antiques,51637422,36501,51600921,2021,0.0007068710750122265,0.9992931289249878
346,Breaking In,51411620,46840590,4571030,2018,0.9110895552406246,0.08891044475937541
347,Cry Me a Sad River,51400614,0,51400614,2018,0.0,1.0
348,Once Upon a Deadpool 2018 Re-release,51349833,6100309,45249524,2018,0.1187990036890675,0.8812009963109325
349,Simmba,51329025,5102129,46226896,2018,0.09940046591572702,0.900599534084273
350,Ambulance,51309115,22309115,29000000,2022,0.43479828096820616,0.5652017190317938
351,Vanguard,50866901,793525,50073376,2020,0.015600026429760288,0.9843999735702397
352,Kingdom,50574061,0,50574061,2019,0.0,1.0
353,Marry Me,50509649,22438180,28071469,2022,0.44423551626739677,0.5557644837326032
354,Breakthrough,50444358,40713082,9731276,2019,0.8070889117074302,0.1929110882925698
355,Just Mercy,50401502,36001502,14400000,2019,0.7142942287711981,0.28570577122880186
356,Uncut Gems,50023780,50023780,0,2019,1.0,0.0
357,Family is Family,49954866,0,49954866,2018,0.0,1.0
358,21 Bridges,49939757,28539757,21400000,2019,0.5714836978481894,0.42851630215181064
359,Luca,49750471,0,49750471,2021,0.0,1.0
360,Song of Youth,49615508,0,49615508,2019,0.0,1.0
361,Death Wish,49562710,34017028,15545682,2018,0.6863431801852643,0.3136568198147357
362,The Grudge,49511319,21221803,28289516,2019,0.4286252806151256,0.5713747193848744
363,The New Mutants,49169594,23852659,25316935,2020,0.4851099441659006,0.5148900558340994
364,Little,48987096,40860481,8126615,2019,0.8341070268790786,0.16589297312092147
365,Fantasy Island,48811343,27309289,21502054,2020,0.5594865316449088,0.44051346835509114
366,Isn't It Romantic,48791187,48791187,0,2019,1.0,0.0
367,The Legend of Hei,48507082,0,48507082,2019,0.0,1.0
368,Belfast,48467139,9250870,39216269,2021,0.19086891017024957,0.8091310898297505
369,Countdown,48021766,25621766,22400000,2019,0.5335448513076341,0.4664551486923659
370,After We Collided,47990414,2386483,45603931,2020,0.04972832699463689,0.9502716730053631
371,"From Today, It's My Turn: The Movie",47895887,0,47895887,2020,0.0,1.0
372,Midsommar,47863365,27426361,20437004,2019,0.5730136399728686,0.4269863600271314
373,Queen & Slim,47861328,43808310,4053018,2019,0.9153174771916065,0.08468252280839345
374,Son of a Rich,47738868,0,47738868,2019,0.0,1.0
375,Trolls 2: World Tour,47648334,450000,47198334,2020,0.009444191689892033,0.9905558083101079
376,47 Meters Down: Uncaged,47582563,22260900,25321663,2019,0.46783734621441053,0.5321626537855895
377,The Magic Tuche,47427990,0,47427990,2018,0.0,1.0
378,Don't Breathe 2,47312950,32712950,14600000,2021,0.6914164092494761,0.3085835907505239
379,Golden Job,47287851,285795,47002056,2018,0.006043729921243407,0.9939562700787566
380,My Hero Academia: World Heroes' Mission,46951862,12271658,34680204,2021,0.26136680159777265,0.7386331984022274
381,Mary Queen of Scots,46712809,16468499,30244310,2018,0.35254782044899075,0.6474521795510092
382,Uncle Drew,46664414,42469946,4194468,2018,0.9101142039413588,0.08988579605864118
383,Acrimony,46403669,43549096,2854573,2018,0.9384838944523978,0.061516105547602284
384,The French Dispatch,46333545,16124375,30209170,2021,0.348006503711296,0.651993496288704
385,Asterix: The Secret of the Magic Potion,45972321,1271953,44700368,2018,0.027667800370575157,0.9723321996294249
386,Chasing the Dragon II: Wild Wild Bunch,45733356,196634,45536722,2019,0.004299575128490461,0.9957004248715096
387,Judy,45701880,24313888,21387992,2019,0.5320106743967644,0.4679893256032356
388,Bajrangi Bhaijaan 2018 Re-release,45579004,0,45579004,2018,0.0,1.0
389,Tanhaji: The Unsung Warrior,45221814,0,45221814,2020,0.0,1.0
390,Love Will Tear Us Apart,45060290,0,45060290,2021,0.0,1.0
391,Child's Play,44907074,29208403,15698671,2019,0.6504187513976083,0.3495812486023917
392,Moonfall,44345119,19060660,25284459,2022,0.4298254335499697,0.5701745664500303
393,Unhinged,44331465,20831465,23500000,2020,0.4699024722056896,0.5300975277943104
394,Winchester,44019588,25091816,18927772,2018,0.5700147852360635,0.4299852147639365
395,In the Heights,43975167,29975167,14000000,2021,0.681638502930529,0.31836149706947103
396,The End of Endless Love,43950000,0,43950000,2020,0.0,1.0
397,Richard Jewell,43745542,22345542,21400000,2019,0.5108072955182497,0.4891927044817504
398,Harriet,43347017,43082155,264862,2019,0.9938897294824232,0.006110270517576792
399,A Shaun the Sheep Movie: Farmageddon,43100248,0,43100248,2019,0.0,1.0
400,Annihilation,43070915,32732301,10338614,2018,0.7599629819798349,0.2400370180201651
401,The Possession of Hannah Grace,43016528,14837422,28179106,2018,0.3449237465190124,0.6550762534809876
402,Spirit Untamed,42717215,17716215,25001000,2021,0.4147324445191476,0.5852675554808524
403,Peninsula,42698327,1231407,41466920,2020,0.02883970137752704,0.971160298622473
404,Monster Hunter,42145959,15162470,26983489,2020,0.3597609441037989,0.6402390558962011
405,Long Day's Journey Into Night,42140994,521365,41619629,2018,0.01237191984602926,0.9876280801539707
406,Overlord,41657844,21704844,19953000,2018,0.5210265802522089,0.47897341974779106
407,The Great Battle,41509280,472166,41037114,2018,0.0113749503725432,0.9886250496274568
408,The Darkest Minds,41142379,12695691,28446688,2018,0.30857940908084097,0.6914205909191591
409,"Lost, Found",41043552,0,41043552,2018,0.0,1.0
410,Underwater,40882928,17291078,23591850,2020,0.4229412824834855,0.5770587175165145
411,Fighting with My Family,40812363,22958886,17853477,2019,0.5625473340026893,0.43745266599731064
412,The War with Grandpa,40745220,21277892,19467328,2020,0.5222181154010213,0.47778188459897875
413,Spiral,40618920,23216862,17402058,2021,0.571577530864927,0.42842246913507304
414,Holmes & Watson,40466970,30573626,9893344,2018,0.7555205146320567,0.24447948536794328
415,Masquerade Hotel,40396244,0,40396244,2019,0.0,1.0
416,Snake Eyes,40064325,28264325,11800000,2021,0.7054736352103773,0.2945263647896227
417,The Last Wish,39756292,0,39756292,2019,0.0,1.0
418,Tokyo Revengers,39714073,0,39714073,2021,0.0,1.0
419,Nightmare Alley,39629195,11338107,28291088,2021,0.2861049032159245,0.7138950967840755
420,Intimate Strangers,39576060,0,39576060,2018,0.0,1.0
421,Thugs of Hindostan,39570044,1449848,38120196,2018,0.0366400401273246,0.9633599598726754
422,Nomadland,39458207,3700000,35758207,2021,0.09377009958916785,0.9062299004108322
423,Uri: The Surgical Strike,39346577,4186168,35160409,2019,0.10639217739322025,0.8936078226067797
424,Sink or Swim,39193850,0,39193850,2018,0.0,1.0
425,Show Dogs,39156854,17857020,21299834,2018,0.4560381689499366,0.5439618310500635
426,Believer,39047153,365639,38681514,2018,0.009364037372968011,0.990635962627032
427,The Spy Gone North,38844509,500803,38343706,2018,0.012892504317663018,0.987107495682337
428,On the Basis of Sex,38673750,24622687,14051063,2018,0.6366769966708685,0.36332300332913153
429,Resident Evil: Welcome to Raccoon City,38600612,17000612,21600000,2021,0.44042337981584334,0.5595766201841567
430,Taxi 5,38598227,0,38598227,2018,0.0,1.0
431,King Richard,38429285,15129285,23300000,2021,0.39369155580177984,0.6063084441982202
432,Arashi Anniversary Tour 5 x 20 Film: Record of Memories,38052695,0,38052695,2021,0.0,1.0
433,Overcomer,38026103,34746945,3279158,2019,0.9137656046426845,0.08623439535731547
434,The Yinyang Master,37690000,0,37690000,2021,0.0,1.0
435,Fat Buddies,37496410,0,37496410,2018,0.0,1.0
436,T-34,37410850,0,37410850,2019,0.0,1.0
437,Sarileru Neekevvaru,37389889,821000,36568889,2020,0.021957807898279665,0.9780421921017204
438,Pain and Glory,37359689,4567338,32792351,2019,0.12225310547954508,0.877746894520455
439,A Witness Out of the Blue,37092694,0,37092694,2019,0.0,1.0
440,Till The End Of The World,37013733,118660,36895073,2018,0.003205837141582018,0.9967941628584179
441,Rurouni Kenshin: Final Chapter Part I - The Final,36964978,0,36964978,2021,0.0,1.0
442,2.0,36945969,4152000,32793969,2018,0.11238032490093845,0.8876196750990616
443,New Interpretation Records of the Three Kingdoms,36747486,0,36747486,2020,0.0,1.0
444,The Intruder,36599361,35419122,1180239,2019,0.9677524697767265,0.03224753022327357
445,The Confidence Man JP: Princess,36109913,0,36109913,2020,0.0,1.0
446,The Door Lock,36100000,0,36100000,2021,0.0,1.0
447,Nothing to Lose,36075317,1016188,35059129,2018,0.028168512005036575,0.9718314879949634
448,The Queen's Corgi,35515687,0,35515687,2019,0.0,1.0
449,Mia and the White Lion,35487190,399471,35087719,2018,0.011256766173934877,0.9887432338260651
450,The Girl in the Spider's Web,35164920,14841338,20323582,2018,0.42204953118050603,0.577950468819494
451,I Fell in Love Like a Flower Bouquet,34975905,0,34975905,2021,0.0,1.0
452,The Hate U Give,34934009,29719483,5214526,2018,0.8507321046376326,0.14926789536236737
453,The Man Standing Next,34664900,113527,34551373,2020,0.003274984205925879,0.9967250157940741
454,My Mom is a Character 3,34360029,0,34360029,2020,0.0,1.0
455,Warrior of the Hornor,34291831,0,34291831,2019,0.0,1.0
456,The Battle: Roar to Victory,34148707,0,34148707,2019,0.0,1.0
457,The Bad Guys: The Movie,34024386,166972,33857414,2019,0.004907421400638942,0.9950925785993611
458,Malignant,33991791,13391791,20600000,2021,0.39397132678298713,0.6060286732170129
459,Doraemon the Movie: Nobita's New Dinosaur,33942341,0,33942341,2020,0.0,1.0
460,The Good Liar,33856058,17156058,16700000,2019,0.5067352495674482,0.49326475043255186
461,The Art of Racing in the Rain,33766787,26395642,7371145,2019,0.7817042823766442,0.21829571762335576
462,Deliver Us from Evil,33718703,0,33718703,2020,0.0,1.0
463,Nobody's Fool,33705333,31713110,1992223,2018,0.9408929441521909,0.05910705584780901
464,Bloodshot,33542457,12561824,20980633,2020,0.37450518308781017,0.6254948169121898
465,Bharat,33185983,2971549,30214434,2019,0.08954229259986062,0.9104577074001394
466,Baaghi 2,33139063,1319579,31819484,2018,0.039819442088631175,0.9601805579113688
467,Brightburn,32893421,17300439,15592982,2019,0.5259543846169117,0.4740456153830883
468,Fly Me to the Saitama,32802347,0,32802347,2019,0.0,1.0
469,Big Red Envelope,32800000,0,32800000,2021,0.0,1.0
470,BTS Permission to Dance on Stage - Seoul: Live Viewing,32600000,6840000,25760000,2022,0.2098159509202454,0.7901840490797546
471,The Hurricane Heist,32517248,6115825,26401423,2018,0.18807941557661953,0.8119205844233804
472,UglyDolls,32450241,20150241,12300000,2019,0.6209581309426947,0.3790418690573053
473,Stuber,32390945,22370452,10020493,2019,0.6906390659488323,0.3093609340511677
474,Licorice Pizza,32358390,17318007,15040383,2021,0.5351937163746404,0.4648062836253596
475,Hit Me Anyone One More Time!,32333512,0,32333512,2019,0.0,1.0
476,Masquerade Night,32287400,0,32287400,2021,0.0,1.0
477,Somewhere Winter,32218990,0,32218990,2019,0.0,1.0
478,Once Upon a Time in Hong Kong,32218874,0,32218874,2021,0.0,1.0
479,Home Sweet Home,32178677,0,32178677,2021,0.0,1.0
480,The Kid Who Would Be King,32140970,16790790,15350180,2019,0.5224108046521309,0.4775891953478691
481,Respect,32121125,24278399,7842726,2021,0.7558390000350237,0.2441609999649763
482,Two Tigers,32001580,0,32001580,2019,0.0,1.0
483,All About Me,31920159,0,31920159,2018,0.0,1.0
484,Bad Times at the El Royale,31882724,17839115,14043609,2018,0.5595229253309724,0.44047707466902764
485,Beautiful Boy,31711319,7649973,24061346,2018,0.24123793147803155,0.7587620685219685
486,Hunter Killer,31672678,15767460,15905218,2018,0.49782528651350544,0.5021747134864946
487,Anna,31626978,7743794,23883184,2019,0.2448477372703772,0.7551522627296228
488,Super Troopers 2,31626386,30617396,1008990,2018,0.9680965760678442,0.03190342393215589
489,Harry Potter and the Sorcerer's Stone 2020 Re-release,31501815,0,31501815,2020,0.0,1.0
490,Honest Thief,31220247,14163574,17056673,2020,0.4536663018713465,0.5463336981286535
491,My Dear Liar,31177968,90545,31087423,2019,0.0029041340987969455,0.997095865901203
492,The Wild Goose Lake,31064835,12573,31052262,2019,0.0004047341632427792,0.9995952658367572
493,The Strangers: Prey at Night,31039126,24586708,6452418,2018,0.7921198554366512,0.20788014456334886
494,Gintama 2: Rules are Made to be Broken,30896653,0,30896653,2018,0.0,1.0
495,The Unholy,30832137,15532137,15300000,2021,0.5037645298475418,0.4962354701524581
496,The Last Duel,30552111,10853945,19698166,2021,0.35526006697213164,0.6447399330278684
497,Like a Boss,30399490,22169514,8229976,2020,0.7292725634541896,0.2707274365458105
498,The Way of the Bug,30355804,0,30355804,2018,0.0,1.0
499,Clergy,30114115,0,30114115,2018,0.0,1.0
500,My Hero Academia: Heroes Rising,29971229,13304000,16667229,2019,0.4438923742499849,0.5561076257500152
501,The Little Things,29942746,15342746,14600000,2021,0.5124027702736416,0.48759722972635844
502,Escape from Mogadishu,29874017,346271,29527746,2021,0.011591042476811872,0.9884089575231881
503,Ice,29806210,0,29806210,2018,0.0,1.0
504,The Roundup,29777413,417011,29360402,2022,0.014004272298604315,0.9859957277013957
505,Free Solo,29390279,17541090,11849189,2018,0.5968330549022689,0.4031669450977311
506,Fall In Love At First Kiss,29206238,0,29206238,2019,0.0,1.0
507,Dark Figure of Crime,29176133,0,29176133,2018,0.0,1.0
508,Pad Man,29045020,1670192,27374828,2018,0.057503558269197265,0.9424964417308027
509,Mirai,28756961,812794,27944167,2018,0.028264252262260953,0.9717357477377391
510,Bath Buddy,28700000,0,28700000,2020,0.0,1.0
511,Master,28692230,0,28692230,2021,0.0,1.0
512,Ala Vaikunthapurramuloo,28477890,0,28477890,2020,0.0,1.0
513,The Last Warrior: Root of Evil,28357398,0,28357398,2021,0.0,1.0
514,Gully Boy,28299498,5566534,22732964,2019,0.19670080366796613,0.8032991963320338
515,The Unbearable Weight of Massive Talent,28251049,20117611,8133438,2022,0.7121013807310306,0.2878986192689694
516,The 355,27824102,14570455,13253647,2022,0.5236630817411466,0.47633691825885344
517,Kim Ji-young: Born 1982,27696393,0,27696393,2019,0.0,1.0
518,Default,27694043,203775,27490268,2018,0.007358080580722721,0.9926419194192773
519,One Cut of the Dead,27590180,52406,27537774,2018,0.0018994439325876091,0.9981005560674124
520,The Happytime Murders,27506452,20706452,6800000,2018,0.7527852737968532,0.2472147262031468
521,Midnight Sun,27365467,9561064,17804403,2018,0.34938428056060583,0.6506157194393942
522,Pok√©mon: Mewtwo Strikes Back - Evolution,27347118,0,27347118,2019,0.0,1.0
523,VIP Policeman,27222681,0,27222681,2018,0.0,1.0
524,The Witches,27103571,203571,26900000,2020,0.0075108553039007295,0.9924891446960993
525,Scoob!,27088425,2188425,24900000,2020,0.08078819643445494,0.9192118035655451
526,My Neighbor Totoro 2018 Re-release,27083857,1144649,25939208,2018,0.042263145902741994,0.9577368540972581
527,Almost a Comedy,26990962,0,26990962,2019,0.0,1.0
528,Total Dhamaal,26911995,2167632,24744363,2019,0.08054519926895051,0.9194548007310495
529,The Faces of My Gene,26796279,0,26796279,2018,0.0,1.0
530,Missing Link,26565710,16649539,9916171,2019,0.626730435587831,0.3732695644121689
531,American Underdog,26514814,26514814,0,2021,1.0,0.0
532,Chaos Walking,26508132,13287908,13220224,2021,0.501276664836285,0.49872333516371503
533,No Manches Frida 2,26493648,9270920,17222728,2019,0.3499299152762957,0.6500700847237043
534,Emma.,26404660,10055355,16349305,2020,0.3808174390429568,0.6191825609570432
535,The Confidence Man JP,26228317,0,26228317,2019,0.0,1.0
536,Badhaai Ho,26125610,0,26125610,2018,0.0,1.0
537,Hichki,26055222,330279,25724943,2018,0.012676115367583512,0.9873238846324165
538,The Courier,26001227,6613432,19387795,2021,0.25435076583116634,0.7456492341688337
539,The Confidence Man JP: The Movie,25958189,0,25958189,2019,0.0,1.0
540,White Boy Rick,25957482,24011188,1946294,2018,0.925019922964793,0.07498007703520704
541,"Paul, Apostle of Christ",25915966,17560475,8355491,2018,0.6775929170458087,0.32240708295419124
542,Leap,25818882,83074,25735808,2020,0.00321756767004861,0.9967824323299513
543,"The Gangster, the Cop, the Devil",25775371,216494,25558877,2019,0.008399258346271718,0.9916007416537282
544,Champions,25757681,0,25757681,2018,0.0,1.0
545,Keys To The Heart,25375866,75134,25300732,2018,0.0029608447648643795,0.9970391552351356
546,Bodies at Rest,25293853,0,25293853,2019,0.0,1.0
547,Booksmart,24959607,22680962,2278645,2019,0.9087066955821861,0.09129330441781396
548,The Kashmir Files,24821898,1485000,23336898,2022,0.059826206682502686,0.9401737933174973
549,Super 30,24701637,2269878,22431759,2019,0.09189180457959123,0.9081081954204088
550,The Father,24555047,2122771,22432276,2020,0.08644947818670434,0.9135505218132957
551,Skyfire,24444590,1105,24443485,2019,4.5204276283627584e-05,0.9999547957237164
552,Stan & Ollie,24420923,5470235,18950688,2018,0.22399788083357866,0.7760021191664214
553,The Witch: Part 1 - The Subversion,24340302,0,24340302,2018,0.0,1.0
554,The Accidental Detective 2: In Action,24243825,179045,24064780,2018,0.0073851795250955655,0.9926148204749045
555,Start-Up,24106579,0,24106579,2019,0.0,1.0
556,Killing for the Prosecution,23929620,0,23929620,2018,0.0,1.0
557,Pinocchio,23889592,1831718,22057874,2019,0.07667431072075237,0.9233256892792476
558,A Rainy Day in New York,23805899,0,23805899,2019,0.0,1.0
559,Interstellar 2020 Re-release,23771122,0,23771122,2020,0.0,1.0
560,Pok√©mon the Movie: The Power of Us,23740788,789170,22951618,2018,0.0332411038757433,0.9667588961242567
561,Spencer,23730484,7086632,16643852,2021,0.29862989730845774,0.7013701026915422
562,The Peanut Butter Falcon,23712090,20457151,3254939,2019,0.862730826342174,0.13726917365782604
563,Little White Lies 2,23623665,0,23623665,2019,0.0,1.0
564,Those Who Wish Me Dead,23468586,7407200,16061386,2021,0.31562191262822564,0.6843780873717743
565,Ossan's Love: Love or Dead,23422744,0,23422744,2019,0.0,1.0
566,Only Cloud Knows,23410836,0,23410836,2019,0.0,1.0
567,The Guernsey Literary and Potato Peel Pie Society,23148937,0,23148937,2018,0.0,1.0
568,The Crimes That Bind,23144130,0,23144130,2018,0.0,1.0
569,New Happy Dad and Son 3: Adventure in Russia,23130469,0,23130469,2018,0.0,1.0
570,Dark Waters,23108017,11136084,11971933,2019,0.48191430705629135,0.5180856929437087
571,The Confidence Man JP: Episode of the Hero,23100870,0,23100870,2022,0.0,1.0
572,The Marksman,23076711,15566093,7510618,2021,0.6745368956607378,0.32546310433926223
573,The Farewell,23076657,17695781,5380876,2019,0.7668260181706562,0.23317398182934382
574,99.9 Criminal Lawyer: The Movie,23055069,0,23055069,2021,0.0,1.0
575,Padmaavat,22991060,11846060,11145000,2018,0.5152463609768319,0.48475363902316815
576,Last Night in Soho,22957625,10127625,12830000,2021,0.4411442821284867,0.5588557178715132
577,Won't You Be My Neighbor?,22844741,22835787,8954,2018,0.9996080498351897,0.0003919501648103605
578,The Knight of Shadows: Between Yin and Yang,22774256,0,22774256,2019,0.0,1.0
579,Black and Blue,22741061,22055313,685748,2019,0.9698453823240701,0.030154617675929897
580,The Day We Lit Up the Sky,22500000,0,22500000,2021,0.0,1.0
581,The Last 10 Years,22456368,0,22456368,2022,0.0,1.0
582,Europe Raiders,22435156,0,22435156,2018,0.0,1.0
583,Late Night,22386555,15499454,6887101,2019,0.6923554785450463,0.30764452145495363
584,Mojin: The Worm Valley,22381583,101516,22280067,2018,0.004535693476194244,0.9954643065238058
585,Les Mis√©rables,22342519,330181,22012338,2019,0.01477814565134755,0.9852218543486525
586,Stree,22075730,0,22075730,2018,0.0,1.0
587,Gretel & Hansel,22051055,15347654,6703401,2020,0.6960054292186927,0.3039945707813073
588,Kaamelott: First Installment,21969341,188000,21781341,2021,0.008557380032473437,0.9914426199675266
589,Poupelle of Chimney Town,21831861,0,21831861,2020,0.0,1.0
590,Parallel Mothers,21745295,2297501,19447794,2021,0.10565508538743669,0.8943449146125633
591,After We Fell,21610371,2170750,19439621,2021,0.10044945549523421,0.8995505445047658
592,Father Stu,21422564,20740439,682125,2022,0.9681585733621801,0.031841426637819824
593,Crazy Romance,21386368,0,21386368,2019,0.0,1.0
594,Shaft,21360215,21360215,0,2019,1.0,0.0
595,Unplanned,21354152,19005109,2349043,2019,0.8899959595679566,0.11000404043204338
596,Rurouni Kenshin: Final Chapter Part II - The Beginning,21318560,0,21318560,2021,0.0,1.0
597,Hotel Mumbai,21314816,9651611,11663205,2019,0.4528123067072219,0.5471876932927782
598,Integrity,21290004,0,21290004,2019,0.0,1.0
599,Stigmatized Properties,21276720,0,21276720,2020,0.0,1.0
600,Wish Dragon,21120000,0,21120000,2021,0.0,1.0
601,Pok√©mon the Movie: Secrets of the Jungle,21097921,0,21097921,2020,0.0,1.0
602,The Secret Mission,21083522,0,21083522,2019,0.0,1.0
603,Doraemon the Movie: Nobita's Little Star Wars 2021,20852061,0,20852061,2022,0.0,1.0
604,The Photograph,20690779,20578185,112594,2020,0.9945582522533347,0.005441747746665314
605,Yarn,20474270,0,20474270,2020,0.0,1.0
606,Violet Evergarden: The Movie,20339624,0,20339624,2020,0.0,1.0
607,Brahms: The Boy II,20311536,12611536,7700000,2020,0.6209050856616654,0.37909491433833464
608,This Is Tomas,20084169,0,20084169,2019,0.0,1.0
609,Ice 2,19788995,0,19788995,2020,0.0,1.0
610,Stillwater,19753611,14465535,5288076,2021,0.7322982618215981,0.2677017381784019
611,Soul Snatcher,19561221,0,19561221,2020,0.0,1.0
612,The Wolf and the Lion,19456454,2072173,17384281,2021,0.10650311716615987,0.8934968828338401
613,The Turning,19428166,15472775,3955391,2020,0.7964094500736714,0.2035905499263286
614,The Specials,19363826,0,19363826,2019,0.0,1.0
615,Les Tuche 4,19259766,0,19259766,2021,0.0,1.0
616,Fate/Stay Night: Heaven's Feel - III. Spring Song,19252497,200000,19052497,2020,0.010388262883510644,0.9896117371164893
617,Dear Evan Hansen,19123412,15002646,4120766,2021,0.784517218998367,0.21548278100163298
618,Always Miss You,19015465,91884,18923581,2019,0.0048320669518205316,0.9951679330481795
619,Beast,18911959,0,18911959,2022,0.0,1.0
620,The Pioneer,18900000,0,18900000,2021,0.0,1.0
621,The Green Knight,18888418,17173321,1715097,2021,0.9091984834304281,0.09080151656957189
622,An Officer and a Spy,18878658,0,18878658,2019,0.0,1.0
623,Antlers,18867659,10619670,8247989,2021,0.5628504309941154,0.43714956900588464
624,Sinkhole,18804231,0,18804231,2021,0.0,1.0
625,Crayon Shin-chan: Honeymoon Hurricane - The Lost Hiroshi,18738951,0,18738951,2019,0.0,1.0
626,Mobile Suit Gundam: Hathaway,18731309,0,18731309,2021,0.0,1.0
627,Greta,18653107,10532219,8120888,2019,0.56463617562479,0.43536382437521
628,Turning Red,18471443,0,18471443,2022,0.0,1.0
629,Takizawa Enbujo Zero,18091395,0,18091395,2020,0.0,1.0
630,The Stronghold,18066143,0,18066143,2021,0.0,1.0
631,The Bob's Burgers Movie,17815672,16904925,910747,2022,0.948879447264184,0.05112055273581597
632,The Promised Neverland,17710977,0,17710977,2020,0.0,1.0
633,Serial (Bad) Weddings 3,17708119,0,17708119,2022,0.0,1.0
634,Kaiji: Final Game,17645779,0,17645779,2020,0.0,1.0
635,Hitman: Agent Jun,17601351,0,17601351,2020,0.0,1.0
636,Bhool Bhulaiyaa 2,17590595,0,17590595,2022,0.0,1.0
637,Bo Gia,17480489,350000,17130489,2021,0.020022323174140037,0.97997767682586
638,The Dry,17424378,364237,17060141,2021,0.020903873871423128,0.9790961261285769
639,Digimon Adventure: Last Evolution Kizuna,17337522,0,17337522,2020,0.0,1.0
640,Gintama: The Final,17252960,0,17252960,2021,0.0,1.0
641,Railway Heroes,17223542,0,17223542,2021,0.0,1.0
642,Promising Young Woman,17202213,6460965,10741248,2020,0.37558917564850525,0.6244108243514948
643,Bye Bye Morons,16955924,0,16955924,2020,0.0,1.0
644,Baaghi 3,16726510,721439,16005071,2020,0.043131472136147944,0.956868527863852
645,Your Turn to Kill,16511822,0,16511822,2021,0.0,1.0
646,I Still Believe,16069730,9868521,6201209,2020,0.6141062108697533,0.38589378913024674
647,Upon the Magic Roads,15990882,0,15990882,2021,0.0,1.0
648,Radhe Shyam,15975683,1860000,14115683,2022,0.11642694712958439,0.8835730528704157
649,Freaky,15920855,9030855,6890000,2020,0.5672342974042537,0.43276570259574626
650,Shin Ultraman,15910863,0,15910863,2022,0.0,1.0
651,Reminiscence,15800193,3900193,11900000,2021,0.24684464297366493,0.7531553570263351
652,Wundersch√∂n,15603848,0,15603848,2022,0.0,1.0
653,Cry Macho,15522017,10310734,5211283,2021,0.6642650887445878,0.3357349112554122
654,The Night House,15437703,7100581,8337122,2021,0.45995061571012213,0.5400493842898778
655,Maison de retraite,15406667,0,15406667,2022,0.0,1.0
656,Blacklight,15376760,9591094,5785666,2022,0.6237395914353869,0.37626040856461307
657,Padre no hay m√°s que uno 2: La llegada de la suegra,15373181,0,15373181,2020,0.0,1.0
658,Minari,15322552,3110580,12211972,2021,0.2030066531998064,0.7969933468001936
659,Drive My Car,15292725,2352240,12940485,2021,0.15381431366875425,0.8461856863312457
660,Bheemla Nayak,15243922,0,15243922,2022,0.0,1.0
661,Something About Love,15204017,0,15204017,2021,0.0,1.0
662,Anita,15026604,556632,14469972,2021,0.03704310035720646,0.9629568996427935
663,Super-h√©ros malgr√© lui,14769147,0,14769147,2022,0.0,1.0
664,The Way Back,14690514,13590514,1100000,2020,0.9251217486331655,0.0748782513668344
665,The Tomorrow War,14400000,0,14400000,2021,0.0,1.0
666,The Personal History of David Copperfield,14399270,1876298,12522972,2020,0.130305077965758,0.869694922034242
667,And So the Baton Is Passed,14368469,0,14368469,2021,0.0,1.0
668,Nightlife,14308789,0,14308789,2020,0.0,1.0
669,Sarkaru Vaari Paata,14199018,0,14199018,2022,0.0,1.0
670,Pawn,14193957,0,14193957,2020,0.0,1.0
671,Crayon Shin-chan: Shrouded in Mystery! The Flowers of Tenkasu Academy,14059824,0,14059824,2021,0.0,1.0
672,Sword Art Online: Progressive - Aria of a Starless Night,14037060,1050000,12987060,2021,0.07480198845057298,0.925198011549427
673,Christmas with the Chosen: The Messengers,13728000,13728000,0,2021,1.0,0.0
674,The Duke,13634047,1360811,12273236,2022,0.099809763014606,0.900190236985394
675,Crayon Shin-chan: Mononoke Ninja Chinpuden,13480355,0,13480355,2022,0.0,1.0
676,OSS 117: From Africa with Love,13433702,0,13433702,2021,0.0,1.0
677,#Alive,13432212,0,13432212,2020,0.0,1.0
678,Howling Village,13394556,0,13394556,2020,0.0,1.0
679,Valimai,13276393,0,13276393,2022,0.0,1.0
680,X,13233690,11765309,1468381,2022,0.8890422096935926,0.11095779030640736
681,School of Magical Animals,13189042,0,13189042,2021,0.0,1.0
682,Come Play,13182254,10475990,2706264,2020,0.7947040013035707,0.2052959986964293
683,Eiffel,13153455,0,13153455,2021,0.0,1.0
684,Hostage: Missing Celebrity,13125970,0,13125970,2021,0.0,1.0
685,Operation Mincemeat,13115528,0,13115528,2022,0.0,1.0
686,Vakeel Saab,13056490,0,13056490,2021,0.0,1.0
687,Monkey King Reborn,13002635,0,13002635,2021,0.0,1.0
688,No Escapes,12916151,0,12916151,2021,0.0,1.0
689,The Bodin's in the Land of Smile,12872253,0,12872253,2021,0.0,1.0
690,Samjin Company English Class,12761386,0,12761386,2020,0.0,1.0
691,The Many Saints of Newark,12737403,8237403,4500000,2021,0.6467097727849233,0.35329022721507675
692,Another Round,12733781,0,12733781,2020,0.0,1.0
693,News of the World,12668325,12668325,0,2020,1.0,0.0
694,Collectors,12640113,0,12640113,2020,0.0,1.0
695,Character,12571501,0,12571501,2021,0.0,1.0
696,Bergen,12554672,0,12554672,2022,0.0,1.0
697,Firestarter,12447345,8254345,4193000,2022,0.663141015212481,0.33685898478751897
698,Shinchan: Crash! Scribble Kingdom and Almost Four Heroes,12221804,0,12221804,2020,0.0,1.0
699,Ducobu 3,12157793,0,12157793,2020,0.0,1.0
700,On Your Mark,12100000,0,12100000,2021,0.0,1.0
701,Legend No. 17,12049148,0,12049148,2021,0.0,1.0
702,The Worst Person in the World,12032314,3034775,8997539,2021,0.2522187336533937,0.7477812663466064
703,Stand by Me,11900000,0,11900000,2021,0.0,1.0
704,On the Line,11772156,0,11772156,2021,0.0,1.0
705,Wotakoi: Love Is Hard for Otaku,11702371,0,11702371,2020,0.0,1.0
706,Let Him Go,11630934,9358025,2272909,2020,0.8045806983342868,0.19541930166571317
707,The Hunt,11481750,5812500,5669250,2020,0.5062381605591482,0.4937618394408518
708,The Fable: The Killer Who Doesn't Kill,11325545,0,11325545,2021,0.0,1.0
709,What Did You Eat Yesterday?,11320893,0,11320893,2021,0.0,1.0
710,Aline,11149329,667201,10482128,2021,0.0598422559779158,0.9401577440220842
711,Memory,11111849,7329043,3782806,2022,0.6595700679517873,0.3404299320482127
712,30 jours max,10998969,0,10998969,2020,0.0,1.0
713,The Voice of Sin,10983063,0,10983063,2020,0.0,1.0
714,Bigfoot Family,10966536,0,10966536,2020,0.0,1.0
715,Harry Potter and the Sorcerer's Stone 2021 Re-release,10962141,799342,10162799,2021,0.0729184198597701,0.9270815801402299
716,One Second,10791301,0,10791301,2020,0.0,1.0
717,Me contro Te - Il film: La vendetta del Signor S,10779891,0,10779891,2020,0.0,1.0
718,Impractical Jokers: The Movie,10691091,10691091,0,2020,1.0,0.0
719,Honest Candidate,10597464,0,10597464,2020,0.0,1.0
720,Two by Two: Overboard!,10540675,0,10540675,2020,0.0,1.0
721,Krack,10442916,0,10442916,2021,0.0,1.0
722,Kaiserschmarrndrama,10357720,0,10357720,2021,0.0,1.0
723,"Caution, Hazardous Wife: The Movie",10356359,0,10356359,2021,0.0,1.0
724,Realm of Terracotta,10341512,0,10341512,2021,0.0,1.0
725,Street Dancer 3D,10339127,0,10339127,2020,0.0,1.0
726,Detective Conan: The Scarlet Alibi,10308627,0,10308627,2021,0.0,1.0
727,The Pirates: The Last Royal Treasure,10258331,0,10258331,2022,0.0,1.0
728,Never Stop,10224935,0,10224935,2021,0.0,1.0
729,My Spy,10200000,0,10200000,2020,0.0,1.0
730,Vaillante,10143170,0,10143170,2022,0.0,1.0
731,The Asadas,10066797,0,10066797,2020,0.0,1.0
732,Beauty and the Beast 2020 Re-release,10055094,467000,9588094,2020,0.046444120761078914,0.953555879238921
733,Black Box,9738741,0,9738741,2021,0.0,1.0
734,Sumikko Gurashi The Movie: The Magical Child Of The Blue Moonlit Night,9735732,0,9735732,2021,0.0,1.0
735,Ainbo,9711938,0,9711938,2021,0.0,1.0
736,Stolen Identity 2,9687188,0,9687188,2020,0.0,1.0
737,Rise,9664406,0,9664406,2022,0.0,1.0
738,The Soul,9600000,0,9600000,2021,0.0,1.0
739,¬°A todo tren! Destino Asturias,9544171,0,9544171,2021,0.0,1.0
740,Talk to Her Undated France Release,9541068,0,9541068,2022,0.0,1.0
741,Baragaki: Unbroken Samurai,9481437,0,9481437,2021,0.0,1.0
742,10 Days with Dad,9472077,2359,9469718,2020,0.000249047806515931,0.9997509521934841
743,Secret Zoo,9471940,0,9471940,2020,0.0,1.0
744,Redeeming Love,9464198,9214020,250178,2022,0.9735658531235293,0.026434146876470672
745,365 Days,9458590,0,9458590,2020,0.0,1.0
746,Okay Madam,9433525,0,9433525,2020,0.0,1.0
747,L'appel de la for√™t,9317347,0,9317347,2020,0.0,1.0
748,Inception 10th Anniversary re-release,9100000,0,9100000,2020,0.0,1.0
749,The Closet,9039424,0,9039424,2020,0.0,1.0
750,Malasa√±a 32,8968845,0,8968845,2020,0.0,1.0
751,100% Wolf,8961732,658764,8302968,2020,0.07350855839027545,0.9264914416097245
752,Break the Silence: The Movie,8954345,0,8954345,2020,0.0,1.0
753,I Hate Summer,8926071,0,8926071,2020,0.0,1.0
754,All About My Mother,8900000,0,8900000,2021,0.0,1.0
755,Downhill,8899195,8287061,612134,2020,0.9312146772826081,0.06878532271739185
756,Les blagues de Toto,8859185,0,8859185,2020,0.0,1.0
757,The Eleventh Chapter,8845525,0,8845525,2021,0.0,1.0
758,The Vault,8803864,0,8803864,2021,0.0,1.0
759,Kaguya-sama: Love Is War,8794981,0,8794981,2021,0.0,1.0
760,The Secret Garden,8721243,0,8721243,2020,0.0,1.0
761,The Prot√©g√©,8639684,7446823,1192861,2021,0.8619323345622363,0.1380676654377637
762,Eltilerin Savasi,8613864,0,8613864,2020,0.0,1.0
763,Smack Dab Kakha,8584856,0,8584856,2022,0.0,1.0
764,The Medium,8529010,0,8529010,2021,0.0,1.0
765,Agent Backkom: Kings Bear,8500000,0,8500000,2021,0.0,1.0
766,Chickenhare and the Hamster of Darkness,8472328,0,8472328,2022,0.0,1.0
767,Honey Lemon Soda,8441488,0,8441488,2021,0.0,1.0
768,Malang,8399765,0,8399765,2020,0.0,1.0
769,The Lord of the Rings: The Fellowship of the Ring 2021 Re-release,8377569,0,8377569,2021,0.0,1.0
770,Don,8283407,0,8283407,2022,0.0,1.0
771,Delicious,8282052,0,8282052,2021,0.0,1.0
772,I Don't Have Any Money Left in My Retirement Account,8204616,0,8204616,2021,0.0,1.0
773,This Much I Know to Be True,8189995,0,8189995,2022,0.0,1.0
774,White Snake 2: Green Snake,8170000,0,8170000,2021,0.0,1.0
775,Lost Illusions,8162814,0,8162814,2021,0.0,1.0
776,New Happy Dad and Son 4,8070000,0,8070000,2021,0.0,1.0
777,Acharya,8048175,832000,7216175,2022,0.1033774737751105,0.8966225262248895
778,Your Eyes Tell,8020474,0,8020474,2020,0.0,1.0
779,AI Amok,7932191,0,7932191,2020,0.0,1.0
780,Silver Skates,7891319,0,7891319,2021,0.0,1.0
781,Sunny Sisters,7880000,0,7880000,2021,0.0,1.0
782,The Lost Prince,7837980,0,7837980,2020,0.0,1.0
783,"My Donkey, My Lover & I",7821615,0,7821615,2020,0.0,1.0
784,Antebellum,7792716,0,7792716,2020,0.0,1.0
785,The Marriage Escape,7760946,0,7760946,2020,0.0,1.0
786,Spirited Away Studio Ghibli Fest 2020,7732435,0,7732435,2020,0.0,1.0
787,Princess Mononoke Studio Ghibli Fest 2020,7673207,0,7673207,2020,0.0,1.0
788,Hard Hit,7633895,0,7633895,2021,0.0,1.0
789,The Heist of the Century,7627100,0,7627100,2020,0.0,1.0
790,Little Canned Men,7600000,0,7600000,2021,0.0,1.0
791,Pushpa: The Rise - Part 1,7592374,1320000,6272374,2021,0.1738586639699256,0.8261413360300743
792,The Mauritanian,7527030,836536,6690494,2021,0.11113759344655195,0.8888624065534481
793,The Ice Road,7502846,0,7502846,2021,0.0,1.0
794,De Gaulle,7501454,0,7501454,2020,0.0,1.0
795,Fukushima 50,7494243,0,7494243,2020,0.0,1.0
796,Love Letter 2021 Re-release,7400000,0,7400000,2021,0.0,1.0
797,Signal: The Movie,7388603,0,7388603,2021,0.0,1.0
798,Bachchhan Paandey,7387882,0,7387882,2022,0.0,1.0
799,'83,7351061,4055660,3295401,2021,0.5517108346672678,0.4482891653327322
800,The Best Years,7344947,0,7344947,2020,0.0,1.0
801,Osomatsusan the Movie 2022 Re-release,7297522,0,7297522,2022,0.0,1.0
802,Contra,7216863,0,7216863,2021,0.0,1.0
803,Mamma Mia! Here We Go Again 2020 Re-release,7209678,0,7209678,2020,0.0,1.0
804,Dear Tutu: Operation T-Rex,7200000,0,7200000,2021,0.0,1.0
805,Water Boys,7200000,0,7200000,2021,0.0,1.0
806,Couple from the Future,7160729,0,7160729,2021,0.0,1.0
807,The (UN)perfect Guy,7154649,0,7154649,2020,0.0,1.0
808,Bohemian Rhapsody 2020 Re-release,7154052,240000,6914052,2020,0.03354742179676636,0.9664525782032336
809,Back to the Wharf,7090000,0,7090000,2020,0.0,1.0
810,Adu,7085946,0,7085946,2020,0.0,1.0
811,Tri bogatyrya i Kon' na trone,7056441,0,7056441,2021,0.0,1.0
812,Fatale,7031289,6306897,724392,2020,0.896975931440167,0.10302406855983305
813,Spycies,6989285,0,6989285,2020,0.0,1.0
814,Jim Button and the Wild 13,6928412,0,6928412,2020,0.0,1.0
815,Dragon Rider,6891870,0,6891870,2020,0.0,1.0
816,Finnick,6739708,0,6739708,2022,0.0,1.0
817,Psy 3: W imie zasad,6725146,0,6725146,2020,0.0,1.0
818,Blood Moon Party,6709383,0,6709383,2020,0.0,1.0
819,Rabbit Academy,6687481,0,6687481,2022,0.0,1.0
820,Innocence,6659968,0,6659968,2020,0.0,1.0
821,Shubh Mangal Zyada Saavdhan,6574905,0,6574905,2020,0.0,1.0
822,Chhapaak,6532100,604334,5927766,2020,0.09251756709174691,0.907482432908253
823,"Love Me, Love Me Not",6494241,0,6494241,2020,0.0,1.0
824,Men,6452788,6452788,0,2022,1.0,0.0
825,Hammamet,6434874,0,6434874,2020,0.0,1.0
826,Lindenberg! Mach dein Ding,6404964,0,6404964,2020,0.0,1.0
827,Midnight Swan,6397065,0,6397065,2020,0.0,1.0
828,Nausica√§ of the Valley of the Wind 2020 Re-release,6395525,0,6395525,2020,0.0,1.0
829,Cyrano,6388842,3873124,2515718,2022,0.6062325535676105,0.3937674464323895
830,Simply Black,6323750,0,6323750,2020,0.0,1.0
831,My Boyfriend's Meds,6292780,2971116,3321664,2020,0.47214680951820975,0.5278531904817902
832,Adieu Monsieur Haffmann,6274720,0,6274720,2022,0.0,1.0
833,Bill & Ted Face the Music,6274027,3439660,2834367,2020,0.5482379977006793,0.4517620022993207
834,Hotel Belgrade,6199413,0,6199413,2020,0.0,1.0
835,Kingmaker,6049522,0,6049522,2022,0.0,1.0
836,How to Be a Good Wife,6029102,0,6029102,2020,0.0,1.0
837,Notre Dame on Fire,6026824,0,6026824,2022,0.0,1.0
838,The Legacy Of Dr. Death: Black File,6024046,0,6024046,2020,0.0,1.0
839,The Rhythm Section,5989583,5437971,551612,2020,0.9079047740051353,0.09209522599486475
840,Jak zostalem gangsterem. Historia prawdziwa,5975729,0,5975729,2020,0.0,1.0
841,The Lion King 2020 Re-release,5948352,0,5948352,2020,0.0,1.0
842,Twiceborn,5880157,11527,5868630,2020,0.001960321807734045,0.9980396781922659
843,The Policeman's Lineage,5869939,0,5869939,2022,0.0,1.0
844,The Royal Bride,5830719,0,5830719,2020,0.0,1.0
845,Beasts Clawing at Straws,5796059,0,5796059,2020,0.0,1.0
846,Radiation House,5793450,0,5793450,2022,0.0,1.0
847,Bheeshma Parvam,5779651,0,5779651,2022,0.0,1.0
848,Goliath,5770632,0,5770632,2022,0.0,1.0
849,Last Letter,5663972,0,5663972,2020,0.0,1.0
850,Yowamushi Pedal: The Movie 2020 Re-release,5624218,0,5624218,2020,0.0,1.0
851,Hocus Pocus 2020 Re-release,5609193,4828000,781193,2020,0.8607298768289842,0.13927012317101586
852,Klassikokkutulek 2: Pulmad ja matused,5543147,0,5543147,2020,0.0,1.0
853,Mama Weed,5432038,29151,5402887,2020,0.005366494122463797,0.9946335058775362
854,The Exorcism of God,5333869,0,5333869,2022,0.0,1.0
855,Divorce Club,5316313,0,5316313,2020,0.0,1.0
856,A Piece of Cake,5253994,0,5253994,2020,0.0,1.0
857,Cindy La Regia,5222322,0,5222322,2020,0.0,1.0
858,Run,5184368,0,5184368,2020,0.0,1.0
859,The Cherry Bushido,5122729,17586,5105143,2022,0.0034329358433756695,0.9965670641566243
860,Love Aaj Kal,5120794,0,5120794,2020,0.0,1.0
861,Masked Ward,5107013,0,5107013,2020,0.0,1.0
862,Ayyappanum Koshiyum,5088713,0,5088713,2020,0.0,1.0
863,Baba Parasi,5084342,0,5084342,2020,0.0,1.0
864,Die K√§nguru-Chroniken,5081127,0,5081127,2020,0.0,1.0
865,The Real Exorcist,5035830,0,5035830,2020,0.0,1.0
866,Mayday,5011408,0,5011408,2020,0.0,1.0
867,Bheeshma,4997080,0,4997080,2020,0.0,1.0
868,Made in Abyss: Dawn of the Deep Soul,4971635,0,4971635,2020,0.0,1.0
869,Godai - The Wunderkind,4948225,0,4948225,2020,0.0,1.0
870,Military Wives,4890505,0,4890505,2020,0.0,1.0
871,Panga,4886124,582720,4303404,2020,0.11926017432222351,0.8807398256777765
872,The Tales for Old and Young,4853143,0,4853143,2020,0.0,1.0
873,Streltsov,4850073,0,4850073,2020,0.0,1.0
874,The SpongeBob Movie: Sponge on the Run,4810790,4810790,0,2020,1.0,0.0
875,The Empty Man,4796993,2992948,1804045,2020,0.6239216942780613,0.37607830572193873
876,The Vets,4788826,0,4788826,2020,0.0,1.0
877,The Broken Hearts Gallery,4781389,4067442,713947,2020,0.8506820925885763,0.14931790741142376
878,Gladiator 20th Anniversary,4780585,0,4780585,2020,0.0,1.0
879,Intruder,4751103,0,4751103,2020,0.0,1.0
880,Persian Lessons,4736459,0,4736459,2020,0.0,1.0
881,Les Segpa,4675530,0,4675530,2022,0.0,1.0
882,Maigret,4663319,0,4663319,2022,0.0,1.0
883,The Cursed,4588389,4588389,0,2022,1.0,0.0
884,Y c√≥mo es √©l?,4578175,1452942,3125233,2022,0.3173627045711446,0.6826372954288554
885,Lesson in Murder,4561449,0,4561449,2022,0.0,1.0
886,Waiting for Bojangles,4538023,0,4538023,2022,0.0,1.0
887,Kaathu Vaakula Rendu Kadhal,4474859,0,4474859,2022,0.0,1.0
888,Permis de construire,4298296,0,4298296,2022,0.0,1.0
889,Pawankhind,4260686,0,4260686,2022,0.0,1.0
890,Vysehrad: Fylm,4239903,0,4239903,2022,0.0,1.0
891,The Godfather 2022  Re-release,4214662,1414662,2800000,2022,0.33565253868518996,0.66434746131481
892,Free! The Final Stroke Part 2,4162396,0,4162396,2022,0.0,1.0
893,Runway 34,4062826,0,4062826,2022,0.0,1.0
894,In Our Prime,3969245,0,3969245,2022,0.0,1.0
895,Koniec swiata czyli Kogel Mogel 4,3957350,0,3957350,2022,0.0,1.0
896,Saunkan Saunkne,3823337,0,3823337,2022,0.0,1.0
897,The Outfit,3770775,3344040,426735,2022,0.8868309565009845,0.11316904349901545
898,Beautiful Minds,3756869,0,3756869,2022,0.0,1.0
899,Un Autre Monde,3755279,0,3755279,2022,0.0,1.0
900,Desperate for Marriage,3707933,0,3707933,2022,0.0,1.0
901,King,3699414,0,3699414,2022,0.0,1.0
902,Naked Truth,3628553,0,3628553,2022,0.0,1.0
903,Disobedient,3601801,0,3601801,2022,0.0,1.0
904,Special Delivery,3581156,0,3581156,2022,0.0,1.0
905,Between Two Worlds,3566973,0,3566973,2022,0.0,1.0
906,Family Camp,3450662,3450662,0,2022,1.0,0.0
907,Artek: Bolshoe puteshestvie,3446947,0,3446947,2022,0.0,1.0
908,Belli ciao,3423873,0,3423873,2022,0.0,1.0
909,The Wandering Moon,3363879,0,3363879,2022,0.0,1.0
910,Fireheart,3329070,0,3329070,2022,0.0,1.0
911,Gangubai Kathiawadi,3271210,592000,2679210,2022,0.1809727898850884,0.8190272101149116
912,Etharkkum Thunindhavan,3266724,0,3266724,2022,0.0,1.0
913,Ox-Head Village,3250402,0,3250402,2022,0.0,1.0
914,Heropanti 2,3235970,0,3235970,2022,0.0,1.0
915,Jana Gana Mana,3135150,0,3135150,2022,0.0,1.0
916,I Want To Know Your Parents,3047523,0,3047523,2022,0.0,1.0
917,Le temps des secrets,3047202,0,3047202,2022,0.0,1.0
918,The Quintessential Quintuplets Movie,3045895,0,3045895,2022,0.0,1.0
919,The Grandmother,3029310,0,3029310,2022,0.0,1.0
920,Hot Blooded,3011684,0,3011684,2022,0.0,1.0
921,Studio 666,2999769,2513963,485806,2022,0.8380521966858114,0.16194780331418854
922,The Young Lovers,2955577,0,2955577,2022,0.0,1.0
923,Extremely Easy Job,2947585,0,2947585,2022,0.0,1.0
924,XxxHolic,2882403,0,2882403,2022,0.0,1.0
925,Chia Khoa Tram Ty,2851565,0,2851565,2022,0.0,1.0
926,La brigade,2833657,0,2833657,2022,0.0,1.0
927,What to Do with the Dead Kaiju?,2827966,0,2827966,2022,0.0,1.0
928,Seventeen Power of Love,2823989,0,2823989,2022,0.0,1.0
929,Eingeschlossene Gesellschaft,2773478,0,2773478,2022,0.0,1.0
930,The Glance of Music,2768401,0,2768401,2022,0.0,1.0
931,Heart of Oak,2693390,0,2693390,2022,0.0,1.0
932,¬°Qu√© Despadre!,2681505,0,2681505,2022,0.0,1.0
933,The Wannabes,2627605,0,2627605,2022,0.0,1.0
934,Vietnamese Horror Story,2569119,0,2569119,2022,0.0,1.0
935,Promises,2533430,0,2533430,2022,0.0,1.0
936,The Phantom of the Open,2524908,0,2524908,2022,0.0,1.0
937,Corro da te,2510224,0,2510224,2022,0.0,1.0
938,Tonbi,2442782,0,2442782,2022,0.0,1.0
939,Costa!!,2416807,0,2416807,2022,0.0,1.0
940,Cherry Magic! Thirty Years Of Virginity Can Make You A Wizard?!: The Movie,2318579,0,2318579,2022,0.0,1.0
941,Ensemble Stars!! Road to Show!!,2287844,0,2287844,2022,0.0,1.0
942,T√©nor,2284140,0,2284140,2022,0.0,1.0
943,Umma,2232593,2121025,111568,2022,0.9500276136313247,0.04997238636867535
944,The Beatles: Get Back - The Rooftop Concert,2209986,976712,1233274,2022,0.44195393092987917,0.5580460690701208
945,Tajemstv√≠ star√© bambitky 2,2195542,0,2195542,2022,0.0,1.0
946,The Nan Movie,2167020,0,2167020,2022,0.0,1.0
947,Around the World in 80 Days,2164782,0,2164782,2022,0.0,1.0
948,Krylya nad Berlinom,2160303,0,2160303,2022,0.0,1.0
949,Raavan,2158734,0,2158734,2022,0.0,1.0
950,Jersey,2156815,0,2156815,2022,0.0,1.0
951,Odinnadtsat molchalivykh muzhchin,2126741,0,2126741,2022,0.0,1.0
952,The Contractor,2112600,1035265,1077335,2022,0.49004307488402915,0.5099569251159708
953,The Beatles: Get Back,1959336,0,1959336,2022,0.0,1.0
954,Jayeshbhai Jordaar,1924623,0,1924623,2022,0.0,1.0
955,Wedding High,1908598,0,1908598,2022,0.0,1.0
956,Aslan: H√ºrkus kayip Elmas,1883289,0,1883289,2022,0.0,1.0
957,Love Mocktail 2,1845639,0,1845639,2022,0.0,1.0
958,2022 Oscar Nominated Short Films: Live Action/2022 Oscar Nominated Short Films: Animation/2022 Oscar Nominated Short Films: Documentary 2022 Oscar Nominated Short Films,1801646,1801646,0,2022,1.0,0.0
959,Alcarr√†s,1783206,0,1783206,2022,0.0,1.0
960,The King's Daughter,1773184,1758963,14221,2022,0.9919799637262687,0.008020036273731322
961,Mission ¬´Sky¬ª,1771349,0,1771349,2022,0.0,1.0
962,Kappei,1770794,0,1770794,2022,0.0,1.0
963,Alors on danse,1760138,0,1760138,2022,0.0,1.0
964,Po cem muzi touz√≠ 2,1757566,0,1757566,2022,0.0,1.0
965,Hridayam,1740483,0,1740483,2022,0.0,1.0
966,The Ancestral,1739866,0,1739866,2022,0.0,1.0
967,"Love, Sex & Pandemic",1712634,0,1712634,2022,0.0,1.0
968,Official Competition,1680881,0,1680881,2022,0.0,1.0
969,Kamen Rider OOO 10th: The Core Medals of Resurrection,1675005,0,1675005,2022,0.0,1.0
970,Aaraattu,1648155,0,1648155,2022,0.0,1.0
971,Confined,1618688,0,1618688,2022,0.0,1.0
972,Undercover,1601934,0,1601934,2022,0.0,1.0
973,Infinite Storm,1600543,1600543,0,2022,1.0,0.0
974,Il sesso degli angeli,1566078,0,1566078,2022,0.0,1.0
975,Another One,1563791,0,1563791,2022,0.0,1.0
976,Full Time,1551683,0,1551683,2022,0.0,1.0
977,Lange flate ball√¶r III,1550107,0,1550107,2022,0.0,1.0
978,F3: Fun and Frustration,1545553,1195000,350553,2022,0.7731860376188976,0.22681396238110244
979,The Desperate Hour,1535877,0,1535877,2022,0.0,1.0
980,For Zeko,1535466,0,1535466,2022,0.0,1.0
981,Gierek,1531831,0,1531831,2022,0.0,1.0
982,V lete ti poviem,1481790,0,1481790,2022,0.0,1.0
983,Dolphin Boy,1413766,0,1413766,2022,0.0,1.0
984,Love Is Better Than Life,1410719,0,1410719,2022,0.0,1.0
985,Heart to Heart,1368824,0,1368824,2022,0.0,1.0
986,Anchor,1357535,0,1357535,2022,0.0,1.0
987,2000 Mules,1335111,1335111,0,2022,1.0,0.0
988,The Passengers of the Night,1274485,0,1274485,2022,0.0,1.0
989,Nh√† Khong B√°n,1271932,0,1271932,2022,0.0,1.0
990,Dilberay K√º√ß√ºk Dev Kadin,1244893,0,1244893,2022,0.0,1.0
991,First Oscar,1230407,0,1230407,2022,0.0,1.0
992,Too Old for Fairy Tales,1223135,0,1223135,2022,0.0,1.0
993,Moya uzhasnaya sestra,1213924,0,1213924,2022,0.0,1.0
994,Johnny's Jr. Our Survival Wars,1211524,0,1211524,2022,0.0,1.0
995,Urban Myths,1199940,0,1199940,2022,0.0,1.0
996,Butt Detective The Movie: The Secret of Souffle Island,1197338,0,1197338,2022,0.0,1.0
997,The Red Herring,1191531,0,1191531,2022,0.0,1.0
998,Brother,1179584,0,1179584,2022,0.0,1.0
999,Swingers,1168817,0,1168817,2022,0.0,1.0
1000,A Radiant Girl,1154112,0,1154112,2022,0.0,1.0
